2 4 4 2 0 0 0 0 0 0 0 0 2 2 2 2 2 2 2 2 2 6 8 4 2 2 2 2 4 2 2 2 2 2 2 2 4 2 2 2 2 2 2 2 2 2 2 2 3 3 
4 2 4 2 0 9 9 9 9 9 9 0 2 4 3 3 3 3 2 2 2 8 6 2 4 4 4 2 2 4 2 3 2 2 3 2 2 2 2 2 4 2 2 2 3 4 2 3 4 4 
4 2 2 3 0 9 9 9 9 9 9 0 2 4 2 2 2 2 4 4 7 8 6 7 4 3 4 4 3 2 3 3 2 2 4 3 3 2 3 3 3 2 2 2 2 2 3 3 4 3 
2 2 4 3 0 9 9 9 9 9 9 0 2 2 2 2 2 4 4 7 6 8 6 6 6 2 2 4 4 3 2 3 3 3 2 2 2 2 4 2 3 3 2 2 3 2 3 2 2 2 
2 4 2 3 0 0 0 0 9 0 0 0 4 2 2 3 3 3 6 6 7 6 6 7 6 6 3 3 4 3 2 2 2 2 4 2 2 2 2 2 2 2 2 3 4 2 3 3 2 2 
6 7 8 7 7 6 6 7 6 8 8 6 8 7 6 7 6 8 6 6 7 8 8 6 6 7 6 6 8 6 7 6 7 6 6 6 6 6 6 7 6 6 6 8 6 6 6 7 6 6
6 8 7 6 8 7 6 7 6 6 7 6 7 6 6 8 8 6 7 6 8 8 6 6 8 7 6 8 6 6 6 6 6 8 6 6 7 6 8 6 6 7 6 6 7 6 8 6 6 8
2 3 3 3 4 4 2 2 4 2 2 4 2 2 3 4 3 3 8 8 6 6 8 8 8 6 4 3 3 4 2 2 2 2 2 6 6 2 4 3 2 2 2 2 2 2 3 2 2 2 
2 2 4 4 2 2 4 2 2 4 2 2 4 3 3 3 4 4 4 7 6 7 7 6 8 3 2 3 2 4 2 2 2 2 2 6 6 3 3 2 2 2 2 3 4 3 3 2 4 2 
2 2 3 2 2 3 2 2 2 2 4 2 3 3 3 3 4 4 3 3 6 8 7 7 3 3 2 3 4 4 3 3 3 2 2 6 6 4 3 2 2 2 2 3 4 3 2 2 3 2 
2 2 0 4 4 3 2 4 3 2 2 3 3 3 3 3 3 3 3 3 4 8 6 2 3 4 4 4 4 2 3 0 0 0 0 9 9 0 0 0 0 2 2 3 2 3 2 4 2 2 
4 4 0 9 2 3 2 3 3 2 2 3 3 4 3 4 4 3 3 3 3 7 8 3 3 3 3 4 2 2 2 0 9 9 9 9 9 9 9 9 0 4 2 2 4 4 2 3 2 2 
2 4 0 9 9 9 3 3 2 2 4 3 3 3 3 3 3 4 4 4 3 8 6 3 2 4 2 4 4 2 2 0 9 9 9 9 9 9 9 9 0 2 2 2 2 3 2 3 3 2 
2 2 0 9 9 9 9 2 4 2 2 3 3 3 3 3 3 3 3 2 2 8 8 2 2 4 2 2 4 4 4 0 9 9 9 9 9 9 9 9 0 2 2 2 2 3 4 2 3 4 
2 2 0 0 0 0 0 0 4 4 4 2 2 2 4 2 2 2 2 2 4 6 7 2 2 4 2 2 2 2 2 0 9 9 9 9 9 9 9 9 0 3 3 2 4 3 2 3 4 4 
2 2 4 4 4 3 3 3 2 2 4 4 2 2 2 3 3 3 4 4 3 8 6 4 4 4 3 2 3 3 3 0 0 0 0 0 0 0 0 0 0 2 2 2 4 2 3 3 3 3 
3 3 2 4 4 4 4 4 2 2 2 2 4 2 2 2 4 4 4 4 2 6 8 2 2 4 4 4 3 2 2 2 4 2 2 3 3 2 2 4 2 4 4 2 2 2 2 2 3 3 
3 4 2 2 2 2 3 3 2 3 4 2 2 4 3 2 3 3 3 2 4 7 8 2 2 2 2 2 2 2 4 4 2 2 2 4 2 2 4 2 2 2 2 2 2 2 4 2 3 2 
3 2 3 3 3 2 2 4 2 2 2 2 2 2 3 2 2 2 3 4 2 6 8 2 4 2 3 3 3 3 2 2 4 2 2 2 2 2 2 2 4 2 3 3 2 2 2 2 2 2 
3 2 4 3 3 2 2 2 2 4 3 2 2 3 2 2 3 3 3 2 2 7 6 2 2 2 3 3 3 3 2 2 2 2 3 3 3 2 3 2 2 3 3 4 2 2 2 2 2 2 
3 3 3 3 3 4 2 2 2 2 3 3 3 2 3 3 2 3 4 2 4 8 6 4 2 4 2 3 3 3 3 2 3 3 3 3 3 3 3 4 3 4 3 2 2 2 4 2 2 2 
2 3 4 3 3 2 2 2 3 3 2 2 3 3 3 3 3 2 3 2 2 6 8 2 2 2 3 3 2 4 3 3 4 3 3 3 4 3 3 2 3 3 3 2 2 2 2 2 2 2 
2 2 3 3 2 2 2 2 3 3 2 2 2 4 2 2 2 3 3 2 2 6 7 4 2 3 3 3 3 2 3 3 2 2 3 2 2 2 2 2 2 2 4 2 2 2 2 2 2 2 
2 2 2 2 2 4 2 2 4 2 2 2 2 2 3 3 3 2 2 2 2 7 6 2 2 2 3 3 3 3 3 3 2 2 2 2 4 2 2 2 2 2 2 2 2 2 2 2 2 2 
2 2 2 2 2 2 2 2 2 2 2 2 2 2 2 2 2 2 2 2 2 3 3 3 3 3 3 2 2 2 2 2 2 2 2 2 2 2 2 2 2 2 2 2 2 2 2 2 2 2 
2 2 2 2 2 2 2 2 2 2 2 2 2 2 2 2 2 2 2 2 2 2 2 2 2 2 2 2 2 2 2 2 2 2 2 2 2 2 2 2 2 2 2 2 2 2 2 2 2 2 
2 2 2 2 2 2 2 2 2 2 2 2 2 2 2 2 2 2 2 2 2 2 2 2 2 2 2 2 2 2 2 2 2 2 2 2 2 2 2 2 2 2 2 2 2 2 2 2 2 2 
2 2 2 2 2 2 2 2 2 2 2 2 2 2 2 2 2 2 2 2 2 2 2 2 2 2 2 2 2 2 2 2 2 2 2 2 2 2 2 2 2 2 2 2 2 2 2 2 2 2 
2 2 2 2 2 2 2 2 2 2 2 2 2 2 2 2 2 2 2 2 2 2 2 2 2 2 2 2 2 2 2 2 2 2 2 2 2 2 2 2 2 2 2 2 2 2 2 2 2 2 
2 2 2 2 2 2 2 2 2 2 2 2 2 2 2 2 2 2 2 2 2 2 2 2 2 2 2 2 2 2 2 2 2 2 2 2 2 2 2 2 2 2 2 2 2 2 2 2 2 2 
2 2 2 2 2 2 2 2 2 2 2 2 2 2 2 2 2 2 2 2 2 2 2 2 2 2 2 2 2 2 2 2 2 2 2 2 2 2 2 2 2 2 2 2 2 2 2 2 2 2 
2 2 2 2 2 2 2 2 2 2 2 2 2 2 2 2 2 2 2 2 2 2 2 2 2 2 2 2 2 2 2 2 2 2 2 2 2 2 2 2 2 2 2 2 2 2 2 2 2 2 
2 2 2 2 2 2 2 2 2 2 2 2 2 2 2 2 2 2 2 2 2 2 2 2 2 2 2 2 2 2 2 2 2 2 2 2 2 2 2 2 2 2 2 2 2 2 2 2 2 2 
2 2 2 2 2 2 2 2 2 2 2 2 2 2 2 2 2 2 2 2 2 2 2 2 2 2 2 2 2 2 2 2 2 2 2 2 2 2 2 2 2 2 2 2 2 2 2 2 2 2 
2 2 2 2 2 2 2 2 2 2 2 2 2 2 2 2 2 2 2 2 2 2 2 2 2 2 2 2 2 2 2 2 2 2 2 2 2 2 2 2 2 2 2 2 2 2 2 2 2 2 
2 2 2 2 2 2 2 2 2 2 2 2 2 2 2 2 2 2 2 2 2 2 2 2 2 2 2 2 2 2 2 2 2 2 2 2 2 2 2 2 2 2 2 2 2 2 2 2 2 2 
0 0 0 0 0 0 0 0 0 0 0 0 0 0 0 0 0 0 0 0 0 0 0 0 0 0 0 0 0 0 0 0 0 0 0 0 0 0 0 0 0 0 0 0 0 0 0 0 0 0 
0 0 0 0 0 0 0 0 0 0 0 0 0 0 0 0 0 0 0 0 0 0 0 0 0 0 0 0 0 0 0 0 0 0 0 0 0 0 0 0 0 0 0 0 0 0 0 0 0 0 
0 0 0 0 0 0 0 0 0 0 0 0 0 0 0 0 0 0 0 0 0 0 0 0 0 0 0 0 0 0 0 0 0 0 0 0 0 0 0 0 0 0 0 0 0 0 0 0 0 0 
0 0 0 0 0 0 0 0 0 0 0 0 0 0 0 0 0 0 0 0 0 0 0 0 0 0 0 0 0 0 0 0 0 0 0 0 0 0 0 0 0 0 0 0 0 0 0 0 0 0 
0 0 0 0 0 0 0 0 0 0 0 0 0 0 0 0 0 0 0 0 0 0 0 0 0 0 0 0 0 0 0 0 0 0 0 0 0 0 0 0 0 0 0 0 0 0 0 0 0 0 
0 0 0 0 0 0 0 0 0 0 0 0 0 0 0 0 0 0 0 0 0 0 0 0 0 0 0 0 0 0 0 0 0 0 0 0 0 0 0 0 0 0 0 0 0 0 0 0 0 0 
0 0 0 0 0 0 0 0 0 0 0 0 0 0 0 0 0 0 0 0 0 0 0 0 0 0 0 0 0 0 0 0 0 0 0 0 0 0 0 0 0 0 0 0 0 0 0 0 0 0 
0 0 0 0 0 0 0 0 0 0 0 0 0 0 0 0 0 0 0 0 0 0 0 0 0 0 0 0 0 0 0 0 0 0 0 0 0 0 0 0 0 0 0 0 0 0 0 0 0 0 
0 0 0 0 0 0 0 0 0 0 0 0 0 0 0 0 0 0 0 0 0 0 0 0 0 0 0 0 0 0 0 0 0 0 0 0 0 0 0 0 0 0 0 0 0 0 0 0 0 0 
0 0 0 0 0 0 0 0 0 0 0 0 0 0 0 0 0 0 0 0 0 0 0 0 0 0 0 0 0 0 0 0 0 0 0 0 0 0 0 0 0 0 0 0 0 0 0 0 0 0 
0 0 0 0 0 0 0 0 0 0 0 0 0 0 0 0 0 0 0 0 0 0 0 0 0 0 0 0 0 0 0 0 0 0 0 0 0 0 0 0 0 0 0 0 0 0 0 0 0 0 
0 0 0 0 0 0 0 0 0 0 0 0 0 0 0 0 0 0 0 0 0 0 0 0 0 0 0 0 0 0 0 0 0 0 0 0 0 0 0 0 0 0 0 0 0 0 0 0 0 0 
0 0 0 0 0 0 0 0 0 0 0 0 0 0 0 0 0 0 0 0 0 0 0 0 0 0 0 0 0 0 0 0 0 0 0 0 0 0 0 0 0 0 0 0 0 0 0 0 0 0 
0 0 0 0 0 0 0 0 0 0 0 0 0 0 0 0 0 0 0 0 0 0 0 0 0 0 0 0 0 0 0 0 0 0 0 0 0 0 0 0 0 0 0 0 0 0 0 0 0 0 
